+--+--+--+--+--+--+--+--+--+--+--+--+--+--+--+--+--+--+--+--+
E  |     |              |     |        |        |           |
+  +  +  +  +--+--+--+  +  +--+  +--+  +  +--+  +--+--+--+  +
|  |  |  |           |     |     |     |  |     |        |  |
+  +  +  +--+--+--+--+--+  +  +--+--+--+--+  +--+  +--+  +  +
|     |           |     |  |        |        |     |     |  |
+--+--+  +--+--+  +  +  +  +--+  +  +  +  +--+  +--+  +--+  +
|        |     |  |  |  |     |  |  |  |     |  |        |  |
+--+--+--+  +--+  +  +  +--+  +  +  +  +--+--+  +  +--+  +  +
|        |     |     |        |  |  |  |     |  |  |     |  |
+  +  +--+--+  +--+--+  +--+--+--+  +  +  +  +  +--+  +--+  +
|  |  |                 |           |     |  |     |  |  |  |
+  +  +  +--+--+--+--+--+  +--+--+  +--+--+  +--+  +  +  +  +
|  |  |  |  |     |        |        |              |  |     |
+  +  +  +  +  +  +  +--+--+  +--+--+  +--+--+--+--+  +--+  +
|  |     |     |  |  |        |     |           |     |     |
+  +--+--+--+--+  +  +--+--+  +  +  +--+--+--+  +--+--+  +  +
|        |        |        |     |  |              |     |  |
+--+--+  +  +--+--+--+--+  +--+--+  +--+--+--+  +  +  +--+  +
|        |           |     |     |     |        |  |  |     |
+  +--+--+--+  +--+  +  +--+  +  +--+  +--+--+--+  +  +--+  +
|  |        |  |     |  |  |  |     |              |     |  |
+  +  +--+  +  +--+--+  +  +  +--+  +--+--+  +--+--+--+  +  +
|     |     |  |     |     |  |  |  |     |  |           |  |
+--+--+  +--+  +  +  +--+  +  +  +  +  +  +  +  +--+--+--+  +
|        |     |  |  |     |  |  |     |  |              |  |
+  +--+--+  +--+--+  +  +  +  +  +--+--+  +--+--+--+--+  +--+
|  |           |     |  |  |  |           |        |        |
+  +--+--+  +  +  +--+--+  +  +--+--+--+--+--+--+  +--+--+  +
|        |  |  |  |           |  |     |     |  |     |     |
+--+--+  +  +--+  +  +--+--+--+  +  +  +--+  +  +  +  +  +  +
|        |     |  |           |     |  |     |     |     |  |
+  +--+--+--+  +  +  +--+  +  +  +--+  +  +--+--+--+--+--+  +
|  |        |  |  |     |  |     |     |  |     |           |
+  +--+  +  +  +  +--+--+  +--+--+  +--+  +  +--+  +  +--+--+
|        |     |  |     |  |        |     |     |  |     |  |
+  +--+--+--+--+  +  +  +  +  +--+--+  +--+--+  +  +--+  +  +
|  |              |  |     |     |     |     |     |     |  |
+  +  +--+  +--+--+  +--+--+  +  +  +--+  +  +--+--+  +--+  +
|        |           |        |     |     |                 S
+--+--+--+--+--+--+--+--+--+--+--+--+--+--+--+--+--+--+--+--+
